PCK2	glycolysis
PCK1	glycolysis
FBP2	glycolysis
BPGM	glycolysis
ALDH3A2	glycolysis
ALDH3A1	glycolysis
LDHAL6B	glycolysis
GAPDH	glycolysis
G6PC3	glycolysis
G6PC2	glycolysis
ALDOA	glycolysis
PGAM4	glycolysis
AKR1A1	glycolysis
PGAM2	glycolysis
FBP1	glycolysis
ADPGK	glycolysis
PGAM1	glycolysis
ALDH1A3	glycolysis
PKLR	glycolysis
HKDC1	glycolysis
LDHAL6A	glycolysis
PFKP	glycolysis
HK2	glycolysis
PFKM	glycolysis
PFKL	glycolysis
HK3	glycolysis
PDHB	glycolysis
PGK2	glycolysis
PKM	glycolysis
LDHB	glycolysis
LDHC	glycolysis
PDHA2	glycolysis
ALDH3B2	glycolysis
ALDH3B1	glycolysis
PDHA1	glycolysis
GPI	glycolysis
DLD	glycolysis
GCK	glycolysis
ACSS2	glycolysis
ACSS1	glycolysis
HK1	glycolysis
GAPDHS	glycolysis
PGM2	glycolysis
PGM1	glycolysis
ENO1	glycolysis
ENO2	glycolysis
DLAT	glycolysis
ALDH9A1	glycolysis
ALDH7A1	glycolysis
ALDH1B1	glycolysis
GALM	glycolysis
ALDOC	glycolysis
ALDOB	glycolysis
MINPP1	glycolysis
ADH7	glycolysis
ADH6	glycolysis
ADH5	glycolysis
ADH4	glycolysis
G6PC	glycolysis
TPI1	glycolysis
ALDH2	glycolysis
LDHA	glycolysis
ENO3	glycolysis
ADH1C	glycolysis
ADH1B	glycolysis
ADH1A	glycolysis
PGK1	glycolysis
BCL2L1	ras_signaling
RGL2	ras_signaling
IKBKB	ras_signaling
RAPGEF5	ras_signaling
AKT2	ras_signaling
FGF20	ras_signaling
RASA4	ras_signaling
IKBKG	ras_signaling
RASAL1	ras_signaling
RASAL3	ras_signaling
RASAL2	ras_signaling
EGF	ras_signaling
CALM2	ras_signaling
CALM3	ras_signaling
CALM1	ras_signaling
PIK3CA	ras_signaling
PIK3CB	ras_signaling
GNG10	ras_signaling
GNG11	ras_signaling
GNG12	ras_signaling
GNG13	ras_signaling
PLA2G6	ras_signaling
PLA2G5	ras_signaling
PLA2G3	ras_signaling
GRIN1	ras_signaling
FGFR1	ras_signaling
SHC4	ras_signaling
IGF1R	ras_signaling
RAB5A	ras_signaling
NF1	ras_signaling
SHC2	ras_signaling
SHC3	ras_signaling
EPHA2	ras_signaling
HTR7	ras_signaling
STK4	ras_signaling
FGFR4	ras_signaling
FGFR2	ras_signaling
FGFR3	ras_signaling
KRAS	ras_signaling
PLD1	ras_signaling
PLD2	ras_signaling
AKT1	ras_signaling
PTPN11	ras_signaling
CSF1	ras_signaling
PLCG1	ras_signaling
KIT	ras_signaling
GNG7	ras_signaling
GNG4	ras_signaling
GNG5	ras_signaling
GNG2	ras_signaling
GNG3	ras_signaling
LAT	ras_signaling
MAPK10	ras_signaling
PAK6	ras_signaling
PAK7	ras_signaling
PAK1	ras_signaling
GNG8	ras_signaling
PAK3	ras_signaling
RASGRP2	ras_signaling
RASGRP3	ras_signaling
NGF	ras_signaling
RASGRP1	ras_signaling
RASGRP4	ras_signaling
RASSF1	ras_signaling
PIK3CG	ras_signaling
HRAS	ras_signaling
RRAS2	ras_signaling
GAB2	ras_signaling
GAB1	ras_signaling
RRAS	ras_signaling
RASA4B	ras_signaling
PLA2G1B	ras_signaling
PDGFD	ras_signaling
MET	ras_signaling
ELK1	ras_signaling
PLA2G12B	ras_signaling
PLA2G12A	ras_signaling
PRKACG	ras_signaling
TIAM1	ras_signaling
PIK3R5	ras_signaling
GRB2	ras_signaling
PIK3R3	ras_signaling
PIK3R2	ras_signaling
PIK3R1	ras_signaling
ANGPT2	ras_signaling
KSR1	ras_signaling
KSR2	ras_signaling
ANGPT1	ras_signaling
ANGPT4	ras_signaling
FIGF	ras_signaling
IGF1	ras_signaling
RASA2	ras_signaling
CHUK	ras_signaling
PLA1A	ras_signaling
MRAS	ras_signaling
PAK4	ras_signaling
VEGFA	ras_signaling
FGF9	ras_signaling
FGF8	ras_signaling
FGF7	ras_signaling
FGF6	ras_signaling
FGF5	ras_signaling
FGF4	ras_signaling
FGF3	ras_signaling
FGF2	ras_signaling
FGF1	ras_signaling
PLA2G16	ras_signaling
RELA	ras_signaling
PLA2G10	ras_signaling
RASA3	ras_signaling
CALML3	ras_signaling
CALML6	ras_signaling
CALML5	ras_signaling
INS	ras_signaling
AKT3	ras_signaling
PAK2	ras_signaling
FGF22	ras_signaling
RALB	ras_signaling
RALA	ras_signaling
FGF21	ras_signaling
PDGFRB	ras_signaling
PDGFRA	ras_signaling
VEGFC	ras_signaling
RALBP1	ras_signaling
PIK3CD	ras_signaling
VEGFB	ras_signaling
RAP1B	ras_signaling
RAP1A	ras_signaling
HGF	ras_signaling
PLCE1	ras_signaling
REL	ras_signaling
RASGRF1	ras_signaling
ABL1	ras_signaling
FLT4	ras_signaling
ABL2	ras_signaling
RAF1	ras_signaling
RHOA	ras_signaling
FLT1	ras_signaling
TEK	ras_signaling
TBK1	ras_signaling
CSF1R	ras_signaling
ARF6	ras_signaling
PLA2G4F	ras_signaling
MAPK3	ras_signaling
FGF19	ras_signaling
MAPK1	ras_signaling
RASGRF2	ras_signaling
FGF13	ras_signaling
FGF12	ras_signaling
MAPK8	ras_signaling
FGF10	ras_signaling
FGF17	ras_signaling
FGF16	ras_signaling
KDR	ras_signaling
FGF14	ras_signaling
RALGDS	ras_signaling
GNB5	ras_signaling
RASSF5	ras_signaling
EFNA5	ras_signaling
EFNA4	ras_signaling
EFNA3	ras_signaling
EFNA2	ras_signaling
EFNA1	ras_signaling
GNB2	ras_signaling
PLA2G2A	ras_signaling
PLA2G2C	ras_signaling
PLA2G2E	ras_signaling
PLA2G2D	ras_signaling
PLA2G2F	ras_signaling
FGF11	ras_signaling
MAPK9	ras_signaling
SOS2	ras_signaling
SOS1	ras_signaling
PLCG2	ras_signaling
RIN1	ras_signaling
BAD	ras_signaling
JMJD7-PLA2G4B	ras_signaling
SHOC2	ras_signaling
PRKACA	ras_signaling
PRKACB	ras_signaling
CDC42	ras_signaling
EGFR	ras_signaling
INSR	ras_signaling
MAP2K2	ras_signaling
MAP2K1	ras_signaling
NGFR	ras_signaling
FOXO4	ras_signaling
SHC1	ras_signaling
PGF	ras_signaling
RAB5C	ras_signaling
RGL1	ras_signaling
RAB5B	ras_signaling
NRAS	ras_signaling
ETS2	ras_signaling
ETS1	ras_signaling
ZAP70	ras_signaling
GNB4	ras_signaling
FGF18	ras_signaling
PDGFA	ras_signaling
PDGFB	ras_signaling
PDGFC	ras_signaling
RAC2	ras_signaling
RAC3	ras_signaling
RAC1	ras_signaling
PRKCA	ras_signaling
GNB1	ras_signaling
PRKCB	ras_signaling
PRKCG	ras_signaling
SYNGAP1	ras_signaling
GNB3	ras_signaling
PLA2G4C	ras_signaling
PLA2G4B	ras_signaling
PLA2G4A	ras_signaling
RASA1	ras_signaling
PLA2G4E	ras_signaling
PLA2G4D	ras_signaling
EXOC2	ras_signaling
BRAP	ras_signaling
KITLG	ras_signaling
NFKB1	ras_signaling
FGF23	ras_signaling
GRIN2B	ras_signaling
MLLT4	ras_signaling
GRIN2A	ras_signaling
GNGT2	ras_signaling
GNGT1	ras_signaling
FASLG	ras_signaling
